R 1920 1080
NO ./texture/beaumur.xpm
SO ./texture/beaumur.xpm
WE ./texture/beaumur.xpm
EA ./texture/beaumur.xpm
S ./texture/beaumur.xpm
F 220,100,0
C 225,30,0


1 1 1 1 1 1 1 1 1 1 1 1 1 1 1
1 1 1 1 0 1 1 1 1 0 0 0 0 0 1
1 1 1 1 0 1 1 1 0 0 0 0 0 0 1
1 1 1 1 0 1 1 0 0 0 0 0 1 0 1
1 0 0 0 0 1 0 0 0 0 0 0 1 0 1
1 0 0 0 0 0 0 0 0 0 1 1 1 0 1
1 0 0 0 0 0 0 0 0 0 1 0 0 0 1
1 0 0 0 0 0 0 0 0 1 1 0 0 0 1
1 0 0 0 0 0 0 0 0 1 0 0 0 0 1
1 0 0 0 0 0 0 0 0 1 0 0 0 0 1
1 1 1 1 0 1 1 1 1 1 0 0 0 0 1
1 1 1 1 0 1 1 1 1 1 1 1 1 0 1
1 1 1 1 0 1 1 1 1 0 0 0 0 0 1
1 1 1 1 0 1 1 1 0 0 0 0 0 0 1
1 1 1 1 0 1 1 0 0 0 0 0 1 0 1
1 0 0 0 0 1 0 0 0 0 0 0 1 0 1
1 0 0 0 0 0 0 0 0 0 1 1 1 0 1
1 0 0 0 0 0 0 0 0 0 1 0 0 0 1
1 0 0 0 0 0 0 0 0 1 1 0 0 0 1
1 0 0 0 0 0 0 0 0 1 0 0 0 0 1
1 0 0 0 0 0 0 0 0 1 0 0 0 0 1
1 1 1 1 0 1 1 1 1 1 0 0 0 0 1
1 1 1 1 0 1 1 1 1 1 0 0 0 0 1
1 1 1 1 0 1 1 1 1 0 0 0 0 0 1
1 1 1 1 0 1 1 1 0 0 0 0 0 0 1
1 1 1 1 0 1 1 0 0 0 0 0 1 0 1
1 0 0 0 0 1 0 0 0 0 0 0 1 0 1
1 0 0 0 0 0 0 0 0 0 1 1 1 0 1
1 0 0 0 0 0 0 0 0 0 1 0 0 0 1
1 0 0 0 0 0 0 0 0 1 1 0 0 0 1
1 0 0 0 0 0 0 0 0 1 0 0 0 0 1
1 0 0 0 0 0 0 0 0 1 0 0 0 0 1
1 1 1 1 0 1 1 1 1 1 0 0 0 0 1
1 1 1 1 0 1 1 1 1 1 1 1 1 0 1
1 1 1 1 0 1 1 1 1 0 0 0 0 0 1
1 1 1 1 0 1 1 1 0 0 0 0 0 1 1
1 1 1 1 0 1 1 1 1 1 1 1 1 1 1
1 1 1 1 0 1 1 1 1 0 0 0 0 0 1
1 1 1 1 0 1 1 1 0 0 0 0 0 0 1
1 1 1 1 0 1 1 0 0 0 0 0 1 0 1
1 0 0 0 0 1 0 0 0 0 0 0 1 0 1
1 0 0 0 0 0 0 0 0 0 1 1 1 0 1
1 0 0 0 0 0 0 0 0 0 1 0 0 0 1
1 0 0 0 0 0 0 0 0 1 1 0 0 0 1
1 0 0 0 0 0 0 0 0 1 0 0 0 0 1
1 0 0 0 0 0 0 0 0 1 0 0 0 0 1
1 1 1 1 0 1 1 1 1 1 0 0 0 0 1
1 1 1 1 0 1 1 1 1 1 1 1 1 0 1
1 1 1 1 0 1 1 1 1 0 0 0 0 0 1
1 1 1 1 0 1 1 1 0 0 0 0 0 0 1
1 1 1 1 0 1 1 0 0 0 0 0 1 0 1
1 0 0 0 0 1 0 0 0 0 0 0 1 0 1
1 0 0 0 0 0 0 0 0 0 1 1 1 0 1
1 0 0 0 0 0 0 0 0 0 1 0 0 0 1
1 0 0 0 0 0 0 0 0 1 1 0 0 0 1
1 0 0 0 0 0 0 0 0 1 0 0 0 0 1
1 0 0 0 0 0 0 0 0 1 0 0 0 0 1
1 1 1 1 0 1 1 1 1 1 0 0 0 0 1
1 1 1 1 0 1 1 1 1 1 0 0 0 0 1
1 1 1 1 0 1 1 1 1 0 0 0 0 0 1
1 1 1 1 0 1 1 1 0 0 0 0 0 0 1
1 1 1 1 0 1 1 0 0 0 0 0 1 0 1
1 0 0 0 0 1 0 0 0 0 0 0 1 0 1
1 0 0 0 0 0 0 0 0 0 1 1 1 0 1
1 0 0 0 0 0 0 0 0 0 1 0 0 0 1
1 0 0 0 0 0 0 0 0 1 1 0 0 0 1
1 0 0 0 0 0 0 0 0 1 0 0 0 0 1
1 0 0 0 0 0 0 0 0 1 0 0 0 0 1
1 1 1 1 0 1 1 1 1 1 0 0 0 0 1
1 1 1 1 0 1 1 1 1 1 1 1 1 0 1
1 1 1 1 0 1 1 1 1 0 0 0 0 0 1
1 1 1 1 0 1 1 1 0 0 0 0 0 1 1
1 1 1 1 0 1 1 0 0 0 0 0 1 1
1 0 0 0 0 1 0 0 0 0 0 0 1
1 0 0 0 0 0 0 0 0 0 1 1 1
1 0 0 0 0 0 0 0 0 0 1
1 0 0 0 0 0 0 0 0 1 1
1 0 0 0 0 0 0 0 0 1
1 0 0 0 N 0 0 0 0 1
1 1 1 1 1 1 1 1 1 1